       C 87, 34, 142
          
   R 800 650  

NO         ./textures/brick.xpm        
SO./textures/brick.xpm
SO./textures/brick.xpm
EA  ./textures/brick.xpm    
WE      ./textures/brick.xpm  
S./textures/tonneau.xpm   


F  72, 11, 23



1111111111111111111111111111111111
1000000000000000000000000000000001
1000200000000000000000000000000001
10E0000000000000000000000000000001
1000000000000000000000000000000001
1000000000000000000000000000000001
1000000000000000000000000000000001
1000000000000000000000000000000001
100000000000000000000000000000000111111111111
111111111111111110000000000000000000000000001
                10000000000000000000000000001
                10000000000000000022222222221
                10000000000000000000000000021
                10000000000000000000000000021
                10000000000000000000000000021
                10000000000000000000000000021
                10000000000000000000000000021
                10000000000000000000000222221
111111111111111110000000000000000000000000001
100000000000000000000000000000010111111111111
100022200000000000000000000000001
100002200000000000000000000000001
100000000000020000000000000000001
100000000000022000000000000000001
100000000000002000000002000000001
100000000000000000000000000000001
100000000000000000000000000000001
111111111111111111111111111111111






