    
   R 800 580   

NO         ./textures/brick.xpm        
SO ./textures/brick.xpm

CT ./textures/metal.xpm
FT ./textures/wood.xpm
  EA  ./textures/brick.xpm  
WE      ./textures/brick.xpm  
S ./textures/tonneau.xpm   


1111111111111111111111111111111111
1000000000000000000000000000000001
1000200000000000000000000000000001
10E0000000000000000000000000000001111111111111111
1000000000000000000000000000000001              1
1000000000000000000000000000000001              1
1000000000000000000000000000000001              1
1000000000000000000000000000000001              1
1000000000000000000000000000000001111111111111111
1111111111111111100000000000000000000000000000001
                100000000000000000000000000000001
        1       100000000000000000222222222200001
                100000000000000000000000000200001
                100000000111110000000000000210011
      11        100000001     1000000000000002221
                100000000111110000000000000210011
                100000000000000000000000000200001
                100000000000000000000002222200001
1111111111111111100000000000000000000000000000001
1000000000000000000000000000000101111111111111111
100022200000000000000000000000001
100002200000000000000000000000001
100000000000020000000000000000001
100000000000022000000000000000001      1
100000000000002000000002000000001     101
100000000000000000000000000000001      1
100000000000000000000000000000001
111111111111111111111111111111111
